        XXXXX    
        X   XXXXX
        X X*XX  X
        X     * X
XXXXXXXXX XXX   X
X....  XX *  *XXX
X....    * ** XX 
X....  XX*  * @X 
XXXXXXXXX  *  XX 
        X * *  X 
        XXX XX X 
          X    X 
          XXXXXX 